############
#          #
#  ####    #
#  #.      #
#  #   $   #
#  #       #
#  #####   #
#      .   #
#    $     #
#   @      #
############
