##########
#@       #
# ####   #
#    #   #
# ## # # #
#  #   # #
# ###### #
#        #
##########
