##########
#@.......#
#.####...#
#....#...#
#.##.#.#.#
#..#...#.#
#.######.#
#........#
##########
