######
#    #
# .$ #
# $. #
# @  #
######
